Лобовикова Александра              | Fullstack разработчица, Namaste Technologies
Любимов Илья                       | Chief People Officer, Serokell
Гейнц Роман                        | Fullstack разработчик
Гарифулина Юлия                    | Software Developer, goTRG
Давыдов Максим                     | Senior Software Developer, Elama
Кац Никита                         | Senior Backend Developer, amoCRM
Тюрин Рамин                        | Front-end Developer, dlg.im
Волков Алексей                     | Senior Test Automation Engeneer, EPAM
Самохвалов Павел                   | Developer
Елизавета Боржкова                 | Business Analyst
Соковых Пётр                       | фрилансер
Артём Проничкин                    | старший консультант, Microsoft
Морозов Сергей                     | 1С-Программист, г.Киров
Антонович Виктор                   | Программист, г. Волгоград
Дмитрий Норкин                     | Junior Researcher, RQC
Дмитрий Костиков                   | Программист, г. Волгоград
Дмитрий Лапшин                     | Software Engineer
Овсянников Дмитрий                 | Product Owner, RCB LLC
Сергей Стремидло                   | Web Developer
Шангин Александр                   | Lead Developer, г. Самара
Андрей Шишкин                      | Lead System Engineer
Антон Щербаков                     | Backend Developer
Дмитрий Богомолов                  | Developer
Михаил Кольцов                     | Backend Developer, ЦТБ
Дмитрий Тырылгин                   | Software Engineer, Dvigus
Хатин Константин                   | Backend developer
Кривоносов Георгий                 | Fullstack Developer, SoftBand
Луконин Кирилл                     | Wireless Engineer
Федосеева Анна                     | Frontend developer
Сметанин Антон                     | Game developer
Николай Тимченко                   | Backend Developer
Клeсс Антoн                        | IT Asset Manager
Чекан Евгений                      | Lead Back-end Developer
Кравцова Валерия                   | Fullstack developer, NetUP LLC
Лукьянчиков Максим                 | Frontend developer
Гуля Илья                          | Android Developer, Yandex
Рыков Михаил                       | Principal Software Engineer, Dell EMC, г. Санкт-Петербург
Макс Янков                         | CTO
Максим Васенков                    | Ведущий программист, Этерон, г. Смоленск
Чалмаев Андрей                     | админ
Лопатин Виктор                     | Software Developer, Ayoxxa
Суслов Алексей                     | Инженер-программист, Eltex
Антон Лазовский                    | Software Engineer, ActiveBC
Борис Чирва                        | Инженер-программист, г. Екатеринбург
Александров Владимир               | Backend Developer, Waves
Константин Лёвин                   | Verification Engineer
Суслов Алексей                     | Инженер-программист, Eltex
Антон Лазовский                    | Software Engineer, ActiveBC
Алексей Гриднев                    | Senior QA engineer, NVIDIA
Руслан Магомедов                   | IT Engineer
Александр Анохин                   | Lead Developer, г. Москва
Вячеслав Ембатуров                 | Software Developer
Павлов Василий Алексеевич          | Software Engineer
Сустретов Максим                   | Backend developer
Шуршев Андрей                      | Backend developer
Домрачев Роман                     | Head of Development
Бельский Кирилл                    | Backend разработчик, Atlas Delivery
Краснов Николай                    | Программист 1С, Москва
Скляров Никита                     | Software Engineer
Павлов Никита                      | Senior Software Engineer, NetCracker
Баранов Кирилл                     | Web-developer
Валерий Рябошапко                  | Backend Developer, Luka, Inc.
Кубота Иван                        | Chief Technology Officer
Антонов Денис                      | Middle Python Developer, CS.Money
Алексей Маслаков                   | Frontend developer
Дмитрий Гудков                     | Backend Developer, Москва
Артур Станкевич                    | Программист, Самара
Даниэль Гинсбург                   | Network Architect
Орешников Иван                     | Research Engineer, Max Planck Institute
Алексей Алишевских                 | Software Engineer, Vound Software
Тимофей Николаев                   | Аналитик, Яндекс
Константин Емельянов               | Developer, NetUP
Багиров Эльшан                     | Backend developer
Сергей Николаев                    | Fullstack Developer
Гарифьянов Денис		   | iOS Developer, dlg.im